1182-4H	embryo
22Rv1	prostate gland
3134	breast
3T3-L1	connective tissue,embryo
416B	bone marrow,bone element
46C	embryo
8988T	pancreas
A172	brain
A204.1	epithelium,musculature of body
A20	blood,bodily fluid
A375	skin of body
A-431	epithelium,skin of body
A549	lung
A673	musculature of body
ACC112	mouth,epithelium,exocrine gland
ACHN	kidney
activated CD4-positive, alpha-beta T cell	blood,bodily fluid
activated CD8-positive, alpha-beta T cell	blood,bodily fluid
activated regulatory T-cells	blood,bodily fluid
activated T-cell	blood,bodily fluid
adipocyte	connective tissue
adipose tissue	connective tissue,adipose tissue
adrenal gland	adrenal gland,endocrine gland
AG04449	connective tissue,skin of body
AG04450	connective tissue,lung
AG08395	connective tissue,skin of body
AG08396	connective tissue,lung
AG08470	connective tissue,skin of body
AG09309	connective tissue,skin of body
AG09319	mouth,connective tissue
AG10803	connective tissue,skin of body
AG20443	connective tissue,skin of body
airway epithelial cell	epithelium
Ammon's horn	brain
amnion	placenta,extraembryonic component
amniotic epithelial cell	placenta,epithelium,extraembryonic component
amniotic stem cell	connective tissue,extraembryonic component
angular gyrus	brain
aorta	blood vessel,vasculature,arterial blood vessel
aortic smooth muscle cell	blood vessel,vasculature,arterial blood vessel,musculature of body
area 11 of Brodmann	brain
arm bone	skeleton,bone element,limb
ARPE-19	epithelium,eye
arthropod fat body	
articular chondrocyte of knee joint	connective tissue,limb
ascending aorta	blood vessel,vasculature,arterial blood vessel
astrocyte of the cerebellum	brain
astrocyte of the hippocampus	brain
astrocyte of the spinal cord	spinal cord
astrocyte	spinal cord,brain
autopod region	limb
B cell	blood,bodily fluid
BE2C	brain
BG01	embryo
BG02	embryo
bile duct	
bipolar neuron	spinal cord,ear,eye,brain
BJ	penis,connective tissue,skin of body
bladder microvascular endothelial cell	blood vessel,vasculature,epithelium,urinary bladder
blood cell	blood,bodily fluid
Bm3 B cell	lymphoid tissue
body of pancreas	pancreas
bone marrow	bone marrow,bone element
bone marrow cell	bone marrow,bone element
bone marrow hematopoietic cell	bone marrow,bone element
bone marrow macrophage	bone marrow,bone element
brain	brain
brain microvascular endothelial cell	blood vessel,vasculature,epithelium,brain
brain pericyte	connective tissue,brain
brainstem motor neuron	brain
breast	breast
breast epithelium	epithelium,breast
bronchial epithelial cell	bronchus,epithelium,lung
bronchial smooth muscle cell	bronchus,lung
bronchus fibroblast of lung	bronchus,connective tissue,lung
brown adipose tissue	connective tissue,adipose tissue
brush border cell of the proximal tubule	epithelium,kidney
C0202	blood,bodily fluid
C2C12	musculature of body
C3H10T1/2	connective tissue,embryo
C4-2B	prostate gland
C802	epithelium,nose
C803	epithelium,nose
C813	epithelium,nose
Caco-2	colon,large intestine,intestine
Caki2	epithelium,kidney
camera-type eye	eye
carcass	
cardiac atrium fibroblast	heart,connective tissue
cardiac fibroblast	heart,connective tissue
cardiac muscle cell	heart,musculature of body
cardiac myoblast	heart,musculature of body
cardiac septum	heart
cardiac ventricle fibroblast	heart,connective tissue
cardiovascular progenitor cell	
caudate nucleus	brain
CD14-negative NK cell	blood,bodily fluid
CD14-positive monocyte	blood,bodily fluid
CD1c-positive myeloid dendritic cell	blood,bodily fluid
CD4-positive, alpha-beta memory T cell	blood,bodily fluid
CD4-positive, alpha-beta T cell	blood,bodily fluid
CD4-positive, CD25-positive, alpha-beta regulatory T cell	blood,bodily fluid
CD4-positive helper T cell	blood,bodily fluid
CD4-positive naive resting alpha-beta T cell	blood,bodily fluid
CD8-positive, alpha-beta memory T cell	blood,bodily fluid
CD8-positive, alpha-beta T cell	blood,bodily fluid
CD8-positive naive resting alpha-beta T cell	blood,bodily fluid
cell-free sample	
central memory CD4-positive, alpha-beta T cell	
central nervous system	
cerebellar cortex	brain
cerebellar granule cell	brain
cerebellar granule layer	brain
cerebellum	brain
cerebellum Purkinje cell layer	brain
cerebral cortex	brain
cerebral cortex, layer 5	brain
CH12.LX	blood,lymph node,bodily fluid
cholangiocyte	epithelium,exocrine gland,liver,connective tissue,endocrine gland
chondrocyte	connective tissue
chorion	extraembryonic component
chorionic villus	placenta,extraembryonic component,embryo
choroid plexus epithelial cell	vasculature,epithelium,brain
cingulate gyrus	brain
c-Kit-negative CD71-positive TER-119-positive erythroid progenitor cells	
c-Kit-positive CD71-negative TER-119-negative erythroid progenitor cells	
c-Kit-positive CD71-positive TER-119-negative erythroid progenitor cells	
c-Kit-positive CD71-positive TER-119-positive erythroid progenitor cells	
CME-L1	limb
CME-W1-Cl.8+	epithelium
CME-W2	epithelium,embryo,limb
CMK	bone marrow,bone element,blood,bodily fluid
COLO829	connective tissue,skin of body
colon	colon,large intestine,intestine
colonic mucosa	colon,large intestine,intestine
common lymphoid progenitor	bone element,bone marrow
common myeloid progenitor	bone element,bone marrow
common myeloid progenitor, CD34-positive	bone element,bone marrow
cord blood hematopoietic stem cell	blood,embryo,bodily fluid
coronary artery	blood vessel,heart,arterial blood vessel,vasculature
cortex	
cortical plate	brain
CWRU1	connective tissue
CyT49	embryo
D341Med	brain
D721Med	brain
Daoy	brain
dedifferentiated amniotic fluid mesenchymal stem cell	connective tissue,extraembryonic component
definitive endodermal cell	embryo
dendritic cell	
dermis blood vessel endothelial cell	blood vessel,vasculature,epithelium,skin of body
dermis lymphatic vessel endothelial cell	lymphatic vessel,epithelium,skin of body,vasculature
dermis microvascular lymphatic vessel endothelial cell	lymphatic vessel,epithelium,skin of body,vasculature
diencephalon	brain
digestive system	
DLD1	epithelium,colon,large intestine,intestine
DNA cloning sample	
DND-41	blood,bodily fluid
DOHH2	
dorsal root ganglion	
dorsolateral prefrontal cortex	brain
DU 145	epithelium,prostate gland
duodenal mucosa	small intestine,intestine
duodenum	small intestine,intestine
E14TG2a.4	embryo
ECC-1	epithelium,uterus
ectodermal cell	embryo
ecto neural progenitor cell	
effector CD4-positive, alpha-beta T cell	
effector memory CD4-positive, alpha-beta T cell	blood,bodily fluid
EH	penis,connective tissue
ELF-1	embryo
EL	penis,connective tissue
ELR	penis,connective tissue
embryo	embryo
embryoid body cell	embryo
embryonic facial prominence	embryo
embryonic fibroblast	connective tissue,embryo
embryonic stem cell	embryo
endocrine cell	endocrine gland
endocrine pancreas	pancreas
endodermal cell	embryo
endometrial microvascular endothelial cells	blood vessel,vasculature,epithelium,uterus
endometrium	uterus
endothelial cell	epithelium
endothelial cell of coronary artery	arterial blood vessel,epithelium,blood vessel,vasculature,heart
endothelial cell of hepatic sinusoid	epithelium,blood vessel,vasculature,exocrine gland,liver,endocrine gland
endothelial cell of umbilical vein	epithelium,blood vessel,vasculature,placenta,extraembryonic component,vein
epiblast cell	embryo
epicardium (mesothelium) cells	
epidermal melanocyte	epithelium,skin of body
epithelial cell of alveolus of lung	epithelium,lung
epithelial cell of esophagus	epithelium,esophagus
epithelial cell of pancreas	epithelium,pancreas
epithelial cell of prostate	epithelium,prostate gland
epithelial cell of proximal tubule	epithelium,kidney
epithelial cell of umbilical artery	arterial blood vessel,epithelium,blood vessel,vasculature,placenta,extraembryonic component
epithelium of mammary gland	exocrine gland,epithelium,mammary gland
erythroblast	bone element,bone marrow
erythroid progenitor cell	bone element,bone marrow
ES-Bruce4	embryo
ES-CJ7	embryo
ES-D3	embryo
ES-E14	embryo
ES-I3	embryo
esophagogastric junction	
esophagus	esophagus
esophagus mucosa	esophagus
esophagus muscularis mucosa	musculature of body,esophagus
esophagus squamous epithelium	epithelium,esophagus
excitatory neuron	
eye	eye
F123	embryo
fallopian tube	
fat pad	connective tissue,adipose tissue
female reproductive system	
femur	skeleton,bone element,limb
fGS/OSS	ovary,gonad
fibroblast	connective tissue
fibroblast of arm	connective tissue,skin of body,limb
fibroblast of breast	breast
fibroblast of dermis	connective tissue,skin of body
fibroblast of gingiva	mouth,connective tissue
fibroblast of lung	connective tissue,lung
fibroblast of mammary gland	exocrine gland,mammary gland,connective tissue
fibroblast of peridontal ligament	mouth,connective tissue
fibroblast of pulmonary artery	blood vessel,vasculature,connective tissue,arterial blood vessel
fibroblast of skin of abdomen	connective tissue,skin of body
fibroblast of skin of back	skin of body
fibroblast of skin of left biceps	skin of body
fibroblast of skin of left quadriceps	skin of body
fibroblast of skin of right biceps	skin of body
fibroblast of skin of right quadriceps	skin of body
fibroblast of skin of scalp	skin of body
fibroblast of skin of upper back	skin of body
fibroblast of the aortic adventitia	blood vessel,vasculature,connective tissue,arterial blood vessel
fibroblast of the conjunctiva	connective tissue,eye
fibroblast of villous mesenchyme	placenta,connective tissue,extraembryonic component
forebrain	brain
forelimb bud	embryo
forelimb	limb
forelimb muscle	musculature of body,limb
forelimb stylopod	limb
forelimb zygopod	limb
foreskin fibroblast	penis,connective tissue,skin of body
foreskin keratinocyte	penis,epithelium,skin of body
foreskin melanocyte	penis
frontal cortex	brain
G1E	embryo
G1E-ER4	embryo
G401.6	epithelium,kidney
G401	kidney
gamma-delta T cell	
ganglionic eminence	embryo
gastrocnemius medialis	musculature of body,limb
gastrocnemius	musculature of body,limb
gastroesophageal sphincter	stomach,musculature of body
germinal center	lymphoid tissue
germinal matrix	brain
globus pallidus	brain
glomerular endothelial cell	vasculature,epithelium,kidney
glomerular visceral epithelial cell	epithelium,kidney
GM03348	connective tissue,skin of body
GM04503	connective tissue,skin of body
GM04504	connective tissue,skin of body
GM06990	blood,bodily fluid
GM06999	blood,bodily fluid
GM08714	blood,bodily fluid
GM10248	blood,bodily fluid
GM10266	blood,bodily fluid
GM10847	blood,bodily fluid
GM12801	blood,bodily fluid
GM12812	blood,bodily fluid
GM12813	blood,bodily fluid
GM12864	blood,bodily fluid
GM12865	blood,bodily fluid
GM12866	blood,bodily fluid
GM12867	blood,bodily fluid
GM12868	blood,bodily fluid
GM12869	blood,bodily fluid
GM12870	blood,bodily fluid
GM12871	blood,bodily fluid
GM12872	blood,bodily fluid
GM12873	blood,bodily fluid
GM12874	blood,bodily fluid
GM12875	blood,bodily fluid
GM12878	blood,bodily fluid
GM12891	blood,bodily fluid
GM12892	blood,bodily fluid
GM13976	blood,bodily fluid
GM13977	blood,bodily fluid
GM15510	blood,bodily fluid
GM18505	blood,bodily fluid
GM18507	lymphoid tissue
GM18526	blood,bodily fluid
GM18951	blood,bodily fluid
GM19099	blood,bodily fluid
GM19193	blood,bodily fluid
GM19238	blood,bodily fluid
GM19239	blood,bodily fluid
GM19240	blood,bodily fluid
GM20000	blood,bodily fluid
GM20431	blood,bodily fluid
GM23248	connective tissue,skin of body,limb
GM23338	skin of body
GM2	embryo
gonadal fat pad	gonad,connective tissue,adipose tissue
granulocyte monocyte progenitor cell	bone marrow,bone element
H1	embryo
H4	epithelium,brain
H54	brain
H7	embryo
H9	embryo
hair follicle dermal papilla cell	connective tissue,skin of body
hair follicular keratinocyte	epithelium,hair follicle,skin of body
HAP-1	bone marrow,bone element
HCEC 1CT	colon,large intestine,intestine
HCT116	epithelium,colon,large intestine,intestine
head	
head of caudate nucleus	brain
heart	heart
heart left ventricle	heart
heart right ventricle	heart
HEK293	epithelium,kidney
HEK293T	epithelium,kidney
HeLa	epithelium,uterus
HeLa-S3	epithelium,uterus
hematopoietic multipotent progenitor cell	blood,bodily fluid
hematopoietic stem cell	blood,bodily fluid
hepatic endoderm	liver,exocrine gland,endocrine gland
hepatic oval stem cell	liver,exocrine gland,endocrine gland
hepatic pit cell	liver,exocrine gland,endocrine gland
hepatic stellate cell	exocrine gland,liver,endocrine gland,connective tissue
hepatocyte	epithelium,liver,exocrine gland,endocrine gland
HepG2	epithelium,liver,exocrine gland,endocrine gland
HFFc6	penis,connective tissue
HFF-Myc	penis,connective tissue
hFib2-iPS4	skin of body
HGPS cell	connective tissue,skin of body
hindbrain	brain
hindlimb bud	embryo
hindlimb muscle	musculature of body,limb
HK-2	epithelium,kidney
HL-60	blood,bodily fluid
HL-60/S4	blood,bodily fluid
HPDE6-E6E7	epithelium,exocrine gland,pancreas
HS-27A	bone marrow,bone element,epithelium
HS-5	bone marrow,bone element,connective tissue
HT1080	epithelium,connective tissue
HT-1197	urinary bladder
HT-1376	urinary bladder
HT-29	epithelium,colon,large intestine,intestine
hTERT-HME1	exocrine gland,epithelium,mammary gland
hTERT-HM	uterus
hTERT RPE-1	epithelium,eye
HTR-8/SVneo	placenta,extraembryonic component,embryo
HUES13	embryo
HUES1	embryo
HUES28	embryo
HUES3	embryo
HUES44	embryo
HUES45	embryo
HUES48	embryo
HUES49	embryo
HUES53	embryo
HUES62	embryo
HUES63	embryo
HUES64	embryo
HUES65	embryo
HUES66	embryo
HUES6	embryo
HUES8	embryo
HUES9	embryo
HuH-7.5	epithelium,liver,exocrine gland,endocrine gland
HuH-7	epithelium,liver,exocrine gland,endocrine gland
IgD-negative memory B cell	blood,bodily fluid
imaginal disc	epithelium
immature natural killer cell	bone marrow,thymus,spleen,lymph node,bone element
IMR-90	connective tissue,lung
induced T-regulatory cell	blood,bodily fluid
inferior parietal cortex	brain
inflammation-experienced regulatory T-cells	blood,bodily fluid
inflammatory macrophage	
insula	brain
intestine	intestine
iPS-11a	skin of body
iPS-11b	skin of body
iPS-11c	skin of body
iPS-15b	skin of body
iPS-17a	skin of body
iPS-17b	skin of body
iPS-18a	skin of body
iPS-18b	skin of body
iPS-18c	skin of body
iPS-20b	skin of body
iPS-27b	skin of body
iPS-27e	skin of body
iPS-5	skin of body
iPSC	
iPS DF 19.11	penis,skin of prepuce of penis,skin of body
iPS DF 19.7	penis,skin of prepuce of penis,skin of body
iPS DF 4.7	penis,skin of prepuce of penis,skin of body
iPS DF 6.9	penis,skin of prepuce of penis,skin of body
iPS-NIHi11	skin of body
iPS-NIHi7	skin of body
iris pigment epithelial cell	epithelium,eye
Ishikawa	uterus
islet of Langerhans	pancreas
islet precursor cell	pancreas
J185a	embryo
jejunum	small intestine,intestine
Jurkat	blood,bodily fluid
Jurkat, Clone E6-1	blood,bodily fluid
K1	thyroid gland,endocrine gland
K562	blood,bodily fluid
Karpas-422	blood,lymph node,bodily fluid
KBM-7	bone marrow,bone element
Kc167	embryo
keratinocyte basal cell carcinoma	
keratinocyte	epithelium,skin of body
keratinocyte squamous cell carcinoma	
kidney capillary endothelial cell	blood vessel,vasculature,epithelium,kidney
kidney collecting duct cell	epithelium,kidney
kidney distal tubule epithelial cell	epithelium,kidney
kidney epithelial cell	epithelium,kidney
kidney glomerular epithelial cell	epithelium,kidney
kidney interstitial cell	kidney
kidney	kidney
kidney loop of Henle thick ascending limb epithelial cell	epithelium,kidney
kidney loop of Henle thin descending limb epithelial cell	epithelium,kidney
kidney tubule cell	epithelium,kidney
KMS-11	bone element
KOPT-K1	blood,lymph node,bodily fluid
KU-19-19	urinary bladder
Kupffer cell	blood vessel,vasculature,exocrine gland,liver,endocrine gland
L-1210 cell	blood,bodily fluid
L1-S8	bone marrow,bone element
L1-S8R	bone marrow,bone element
large intestine	large intestine,intestine
lateral mesodermal cell	embryo
layer of hippocampus	brain
left arm bone	skeleton,bone element,limb
left cardiac atrium	heart
left colon	colon,large intestine,intestine
left kidney	kidney
left leg bone	skeleton,bone element,limb
left lobe of liver	liver,exocrine gland,endocrine gland
left lung	lung
left renal cortex interstitium	kidney
left renal pelvis	kidney,ureter
left ventricle myocardium	heart,musculature of body
left ventricle myocardium inferior	heart
left ventricle myocardium superior	heart
leg bone	skeleton,bone element,limb
leukemia stem cell	
LHCN-M2	musculature of body
limb	limb
liver dendritic cell	liver,exocrine gland,endocrine gland
liver	liver,exocrine gland,endocrine gland
LNCaP clone FGC	epithelium,prostate gland
LNCAP	prostate gland
Loucy	blood,bodily fluid
LoVo	epithelium,colon,large intestine,intestine
lower leg skin	skin of body,limb
lower lobe of left lung	lung
lower lobe of right lung	lung
luminal epithelial cell of mammary gland	exocrine gland,epithelium,mammary gland
lung	lung
lung microvascular endothelial cell	blood vessel,vasculature,epithelium,lung
M059J	brain
macrophage	bone element,bone marrow
male accessory sex gland	
male reproductive system	
mammary epithelial cell	exocrine gland,epithelium,mammary gland
mammary gland	exocrine gland,mammary gland
mammary microvascular endothelial cell	blood vessel,vasculature,epithelium,breast
mammary stem cell	exocrine gland,mammary gland
mature B cell	blood,bodily fluid
mbn2	embryo
MCF 10A	exocrine gland,epithelium,mammary gland
MCF-7	exocrine gland,epithelium,mammary gland
MDA-MB-231	exocrine gland,epithelium,mammary gland
medulla oblongata	brain
megakaryocyte	bone marrow,bone element
megakaryocyte-erythroid progenitor cell	bone element,bone marrow
megakaryocyte progenitor cell	bone element,bone marrow
Mel-2183	epithelium,skin of body
melanocyte of skin	skin of body
MEL-GATA-1-ER	spleen,immune organ
MEL	spleen,immune organ
mesangial cell	epithelium,connective tissue,kidney
mesenchymal stem cell	connective tissue
mesenchymal stem cell of adipose	connective tissue,adipose tissue
mesenchymal stem cell of the bone marrow	bone marrow,bone element,connective tissue
mesenchymal stem cell of Wharton's jelly	connective tissue,extraembryonic component
mesendoderm	embryo
mesenteric fat pad	connective tissue,adipose tissue
mesodermal cell	embryo
mesoderm	embryo
mesothelial cell	epithelium
metanephros	kidney
Meynert cell	brain
MG63	bone element
midbrain	brain
middle frontal area 46	brain
middle frontal gyrus	brain
mid-neurogenesis radial glial cells	
ML-DmBG1-c1	
ML-DmBG2-c2	
ML-DmBG3-c2	brain
ML-DmD11	eye
ML-DmD16-c3	epithelium
ML-DmD17-c3	epithelium,embryo
ML-DmD20-c2	epithelium
ML-DmD20-c5	epithelium
ML-DmD21	epithelium
ML-DmD32	epithelium
ML-DmD4-c1	
ML-DmD8	epithelium
ML-DmD9	epithelium
MM.1S	blood,bodily fluid
MN1	spinal cord
mole	skin of body
monocyte	blood,bodily fluid
mononuclear cell	blood,bodily fluid
motor neuron	spinal cord,brain
mouse embryonic stem cell	embryo
MSiPS	blood,bodily fluid
MSLCL	blood,bodily fluid
mucosa of descending colon	colon,large intestine,intestine
mucosa of gallbladder	gallbladder
mucosa of rectum	large intestine,intestine
mucosa of stomach	stomach
mucosa of urinary bladder	urinary bladder
Muller cell	eye
muscle layer of colon	colon,large intestine,intestine
muscle layer of duodenum	small intestine,intestine
muscle layer of esophagus	esophagus
muscle of arm	musculature of body,limb
muscle of back	musculature of body
muscle of leg	musculature of body,limb
muscle of trunk	musculature of body
muscle precursor cell	musculature of body
myeloid cell	bone element,bone marrow
myoblast	musculature of body
myocyte	musculature of body
myoepithelial cell of mammary gland	exocrine gland,epithelium,mammary gland
myometrial cell	uterus
myotome	
myotube	musculature of body
naive B cell	blood,bodily fluid
naive thymus-derived CD4-positive, alpha-beta T cell	blood,bodily fluid
naive thymus-derived CD8-positive, alpha-beta T cell	blood,bodily fluid
NAMALWA	blood,bodily fluid
nasal cavity respiratory epithelium epithelial cell of viscerocranial mucosa	epithelium,nose
natural killer cell	blood,bodily fluid
NB4	bone marrow,bone element
NCI-H1437	lung
NCI-H226	lung
NCI-H460	epithelium,lung
NCI-H929	bone marrow,bone element
NC-NC	blood,bodily fluid
nephron	epithelium,kidney
nephron progenitor cell	kidney
neural cell	
neural crest cell	embryo
neural progenitor cell	
neural tube	epithelium,embryo
neurectodermal cell	embryo
neuroepithelial stem cell	epithelium,embryo
neuron	
neuronal stem cell	embryo
neuron of cerebral cortex	brain
neurosphere	
neutrophil	blood,bodily fluid
NIH3T3	connective tissue,embryo
non-pigmented ciliary epithelial cell	epithelium
NT2/D1	epithelium,gonad,testis
occipital lobe	brain
occipital pole	brain
OCI-LY1	bone marrow,bone element
OCI-LY3	bone marrow,bone element,immune organ,lymph node
OCI-LY7	blood,bodily fluid
olfactory bulb	brain
omental fat pad	connective tissue,adipose tissue
omentum	
OSC	ovary,gonad
OSS	ovary,gonad
osteoblast	connective tissue
osteocyte	bone element,connective tissue
ovary	ovary,gonad
OVCAR3	ovary,epithelium,gonad
Panc1	epithelium,pancreas
pancreas	pancreas
paracentral lobule	brain
parathyroid adenoma	paraythroid gland
parietal epithelial cell	epithelium,kidney
parietal lobe	brain
Patski	connective tissue,kidney
PC-3	prostate gland
PC-9	lung
penis	penis
pericardium fibroblast	connective tissue,pericardium
pericardium	pericardium
peripheral blood mononuclear cell	blood,bodily fluid
peritoneum	
Peyer's patch	lymphoid tissue,intestine
PFSK-1	connective tissue,brain
placental basal plate	placenta,extraembryonic component
placental epithelial cell	placenta,epithelium,extraembryonic component
placental pericyte	placenta,connective tissue,extraembryonic component
placenta	placenta,extraembryonic component
pons	brain
posterior cingulate cortex	brain
posterior cingulate gyrus	brain
posterior foregut	
posterior vena cava	blood vessel,vasculature,vein
primitive gut cell	embryo
progenitor cell of endocrine pancreas	endocrine gland,pancreas
prostate gland	prostate gland
psoas muscle	musculature of body
pulmonary artery endothelial cell	blood vessel,vasculature,epithelium,arterial blood vessel
Purkinje cell	brain
putamen	brain
pyramidal neuron	brain
R1	embryo
radial glial cell	embryo
Raji	lymphoid tissue
Ramos	
RCC 7860	epithelium,kidney
RCC	kidney
rectal smooth muscle tissue	musculature of body,large intestine,intestine
rectum	large intestine,intestine
regular cardiac myocyte	heart,musculature of body
regulatory T cell	blood,bodily fluid
renal cortex interstitium	kidney
renal cortical epithelial cell	epithelium,kidney
renal glomerulus	epithelium,kidney
renal pelvis	kidney
retina	eye
retinal alpha ganglion cell	eye
retinal pigment epithelial cell	epithelium,eye
right arm bone	skeleton,bone element,limb
right atrium auricular region	heart
right cardiac atrium	heart
right kidney	kidney
right leg bone	skeleton,bone element,limb
right lobe of liver	liver,exocrine gland,endocrine gland
right lung	lung
right renal cortex interstitium	kidney
right renal pelvis	kidney,ureter
right ventricle myocardium	heart,musculature of body
Right ventricle myocardium inferior	heart
Right ventricle myocardium superior	heart
RKO	epithelium,colon,large intestine,intestine
RPMI7951	epithelium,skin of body
RPMI8226	blood,bodily fluid
RUES2	embryo
RWPE1	epithelium,prostate gland
RWPE2	epithelium,prostate gland
S1	embryo
S2	embryo
S2R+	embryo
S3	embryo
salivary gland	mouth,exocrine gland
sciatic nerve	nerve
Sg4	embryo
SH-SY5Y	bone marrow,bone element,epithelium
sigmoid colon	colon,large intestine,intestine
SJCRH30	connective tissue,musculature of body
SJSA1	bone element
skeletal muscle cell	musculature of body
skeletal muscle myoblast	musculature of body
skeletal muscle satellite cell	musculature of body
skeletal muscle tissue	musculature of body
skin fibroblast	connective tissue,skin of body
skin of body	skin of body
SK-MEL-5	epithelium,skin of body
SK-N-DZ	brain
SK-N-MC	epithelium,brain
SK-N-SH	brain
small intestine	small intestine,intestine
smooth muscle cell	musculature of body
smooth muscle cell of bladder	urinary bladder
smooth muscle cell of the brain vasculature	vasculature
smooth muscle cell of the coronary artery	blood vessel,heart,arterial blood vessel,vasculature
smooth muscle cell of the pulmonary artery	blood vessel,vasculature,arterial blood vessel
smooth muscle cell of the umbilical artery	arterial blood vessel,blood vessel,vasculature,placenta,extraembryonic component
smooth muscle cell of trachea	trachea
sperm	testis
spinal cord motor neuron	spinal cord
spinal cord	spinal cord
splanchnic mesodermal cell	embryo
spleen	spleen,immune organ
splenic B cell	spleen,blood,bodily fluid
stem cell of epidermis	epithelium,skin of body
stomach smooth muscle	stomach,musculature of body
stomach	stomach
stromal cell of bone marrow	bone marrow,bone element,connective tissue
subcutaneous abdominal adipose tissue	connective tissue,adipose tissue
subcutaneous adipose tissue	connective tissue,adipose tissue
subcutaneous preadipocyte	connective tissue
substantia nigra	brain
SU-DHL-2	immune organ,lymph node
SU-DHL-4	immune organ,lymph node
SU-DHL-6	
superior temporal gyrus	brain
suppressor macrophage	
suprapubic skin	skin of body
SW480	epithelium,colon,large intestine,intestine
SW620	colon,large intestine,intestine
T47D	exocrine gland,epithelium,mammary gland
T98G	brain
T-cell	blood,bodily fluid
telencephalon	brain
temporal lobe	brain
testis	gonad,testis
T follicular helper cell	
T-helper 17 cell	blood,bodily fluid
T-helper 1 cell	blood,bodily fluid
T-helper 22 cell	
T-helper 2 cell	blood,bodily fluid
T-helper 9 cell	
thoracic aorta	blood vessel,vasculature,arterial blood vessel
thoracic aorta endothelial cell	blood vessel,vasculature,epithelium,arterial blood vessel
thoracic segment muscle	musculature of body
THP-1	blood,bodily fluid
thymus	endocrine gland,immune organ,thymus
thyroid gland	thyroid gland,endocrine gland
tibial artery	blood vessel,vasculature,arterial blood vessel,limb
tibial nerve	nerve,limb
tongue	tongue,mouth
tracheal epithelial cell	epithelium,trachea
transverse colon	colon,large intestine,intestine
trophoblast cell	extraembryonic component,embryo
trophoblast	embryo
TT2	embryo
TTC549	epithelium,liver,exocrine gland,endocrine gland
type B pancreatic cell	epithelium,endocrine gland,pancreas
U2OS	epithelium,bone element
U-87 MG	epithelium,brain
UCH-1	skeleton,bone element
UCSF-4	embryo
umbilical cord	extraembryonic component
upper lobe of left lung	lung
upper lobe of right lung	lung
ureter	kidney,ureter
urinary bladder	urinary bladder
urothelium cell line	epithelium
uterine smooth muscle cell	uterus
uterus	uterus
vagina	vagina
VCaP	epithelium,prostate gland
vein endothelial cell	blood vessel,vasculature,vein,epithelium
WERI-Rb-1	eye
white fat cell	connective tissue,adipose tissue
whole organism	
WI38	connective tissue,lung
WTC11	skin of body
WW6	embryo
yolk sac	epithelium,extraembryonic component
ZHBTc4	embryo
zone of skin	skin of body
